OOOOOOOOOO
O O    O O
O . OO   O
O O O    O
O OOOO O.O
O OOO    U
O OOOOOO.O
O O      O
O O OOOOOO
O . OOOOOO
OOOOOOOOOO
